1111111111111111111
1P100001C00010000C1
1010110101101011111
1010010001000010001
1000110111000000101
11000E0000011110101
1000110110000010001
1010100011111010101
1C1000100000C0101C1
1111111111111111111