111111111111111111111111111111111
1P1000C1000010C01C000010000010001
101011010110101011101011010010101
101001000010001000101000011010101
1000011110101000100000100010001C1
110100000011101010100111101010101
10000101101C001000101100000010101
1010100C1111101010100001111110001
1C100010000010C0E0001000C1C000101
111111111111111111111111111111111
